45
21
00 00 00 00 00 00 00 00 00 00 00 00 00 00 00 00 00 00 00 00 00 00 00 00 00 00 00 00 00 00 00 00 00 00 00 00 00 00 00 00 00 00 00 00 00 00 00 00 00
00 00 00 00 00 00 00 00 00 00 00 00 00 00 00 00 00 00 00 00 00 00 00 00 00 00 00 00 00 00 00 00 00 00 00 00 00 00 00 00 00 00 00 00 00 00 00 00 00
00 00 00 00 00 00 00 00 00 00 00 00 00 00 00 00 00 00 00 00 00 00 00 00 00 00 00 00 00 00 00 00 00 00 00 00 00 00 00 00 00 00 00 00 00 00 00 00 00
00 00 00 00 00 00 00 00 00 00 00 00 00 00 00 00 00 00 00 00 00 00 00 00 00 00 00 00 00 00 00 00 00 00 00 00 00 00 00 00 00 00 00 00 00 00 00 00 00
00 00 00 00 00 00 00 00 00 00 00 00 00 00 00 00 00 00 00 00 00 00 00 00 00 00 00 00 00 00 00 00 00 00 00 00 00 00 00 00 00 00 00 00 00 00 00 00 00
00 00 00 00 00 00 00 00 00 00 00 00 00 00 00 00 00 00 00 00 00 00 00 00 00 00 00 00 00 00 00 00 00 00 00 00 00 00 00 00 00 00 00 00 00 00 00 00 00
00 00 00 00 04 01 01 01 01 01 01 05 00 00 00 00 00 00 00 00 00 00 00 00 00 00 00 00 00 00 00 00 00 00 00 00 00 00 00 00 00 00 00 00 00 00 00 00 00
00 00 00 00 14 11 11 11 11 11 11 15 00 00 00 00 00 00 00 00 00 00 00 00 00 00 00 00 00 00 00 00 00 00 00 00 00 00 00 00 00 00 00 00 00 00 00 00 00
00 00 00 00 00 00 00 00 00 00 00 00 00 00 00 00 00 00 00 00 00 00 00 00 00 00 00 00 00 00 00 00 00 00 00 00 00 00 00 00 00 00 00 00 00 00 00 00 00
00 00 00 00 00 00 00 00 04 01 01 01 01 01 05 00 00 00 00 00 04 01 01 01 01 05 00 00 00 00 00 00 00 00 00 00 00 00 00 00 00 00 00 00 00 00 00 00 00
00 00 00 00 00 00 00 00 14 11 11 11 11 11 15 00 00 00 00 00 14 11 11 11 11 15 00 00 00 00 00 00 00 00 00 00 00 00 00 00 00 00 00 00 00 00 00 00 00
00 00 00 00 00 00 00 00 00 00 00 00 00 00 00 00 00 00 00 00 00 00 00 00 00 00 00 00 00 00 04 01 01 01 01 01 01 05 00 00 00 00 00 00 00 00 00 00 00
04 01 01 01 01 01 01 05 00 00 00 00 00 00 00 00 00 00 00 00 00 00 06 00 00 00 00 00 00 00 14 11 11 11 11 11 11 15 00 00 00 00 00 00 00 00 00 00 00
14 11 11 11 11 11 11 15 00 00 00 00 00 06 00 00 04 01 01 01 05 00 16 00 00 00 00 00 00 00 00 00 00 00 00 00 00 00 00 00 00 00 00 00 00 00 00 00 00
00 00 00 00 00 00 00 00 00 00 00 06 00 16 00 00 14 11 11 11 15 06 00 00 07 00 00 00 00 00 00 00 00 00 00 00 00 00 00 00 00 00 00 00 00 00 00 00 00
00 00 00 00 00 00 00 00 00 00 00 16 00 00 00 00 00 00 00 00 00 16 00 00 17 00 06 07 00 00 00 00 00 00 04 01 01 01 05 00 00 00 00 00 00 00 00 00 00
00 00 00 00 00 00 00 00 00 06 00 00 00 00 07 00 00 00 00 06 00 00 00 00 00 00 16 17 00 00 06 00 00 00 14 11 11 11 15 00 00 00 00 00 00 00 00 00 00
00 00 00 00 00 00 00 00 00 16 00 00 00 00 17 00 00 00 00 16 00 00 00 00 00 00 00 00 00 00 16 00 00 00 00 00 00 00 00 00 00 00 00 00 00 00 00 00 00
00 00 00 00 00 00 00 00 00 00 00 00 00 00 00 00 00 00 00 00 00 00 00 00 00 00 00 00 00 00 00 00 00 00 00 00 00 00 00 00 00 00 00 00 00 00 00 00 00
02 03 02 03 02 02 02 03 02 03 02 02 02 03 02 03 02 02 02 03 02 03 02 02 02 03 02 03 02 02 02 03 02 03 02 02 02 03 02 03 02 02 02 03 02 03 02 02 02
12 13 12 13 12 12 12 13 12 13 12 12 12 13 12 13 12 12 12 13 12 13 12 12 12 13 12 13 12 12 12 13 12 13 12 12 12 13 12 13 12 12 12 13 12 13 12 12 12